%%%%%%%%%%%%%%%%
%P      %      .%
% %%%%% % %%%%% %
%              %
%%%%%%%%%%%%%%%%