%%%%%%%%%%
%P   %   %
% % % % %%
% %   %  .
%%%%%%%%%%